1111111111111
10E00000P00C1
1000000000001
1000C00000C01
1111111111111
